"filename", "language", "JavaScript", "SCSS", "comment", "blank", "total"
"c:\Users\khang\Desktop\FBLA\2024-25\SLC\slc-app\src\App.js", "JavaScript", 2, 0, 0, 1, 3
"c:\Users\khang\Desktop\FBLA\2024-25\SLC\slc-app\src\components\AccountPage\ProjectComp\index.js", "JavaScript", 1, 0, 0, 0, 1
"c:\Users\khang\Desktop\FBLA\2024-25\SLC\slc-app\src\components\ContactDashBoard\DashBoardContact\index.js", "JavaScript", 43, 0, 0, 1, 44
"c:\Users\khang\Desktop\FBLA\2024-25\SLC\slc-app\src\components\ContactDashBoard\DashBoardContact\index.scss", "SCSS", 0, 2, 1, 1, 4
"c:\Users\khang\Desktop\FBLA\2024-25\SLC\slc-app\src\components\Footer\index.scss", "SCSS", 0, 0, -89, -15, -104
"c:\Users\khang\Desktop\FBLA\2024-25\SLC\slc-app\src\components\Home\HomeCard\index.js", "JavaScript", 34, 0, -1, 2, 35
"c:\Users\khang\Desktop\FBLA\2024-25\SLC\slc-app\src\components\Home\HomeCard\index.scss", "SCSS", 0, -85, -37, -25, -147
"c:\Users\khang\Desktop\FBLA\2024-25\SLC\slc-app\src\components\Home\index.js", "JavaScript", -5, 0, -1, -3, -9
"c:\Users\khang\Desktop\FBLA\2024-25\SLC\slc-app\src\components\Home\index.scss", "SCSS", 0, 8, -21, -8, -21
"c:\Users\khang\Desktop\FBLA\2024-25\SLC\slc-app\src\components\Interior\ApplicationCard\index.js", "JavaScript", 535, 0, 22, 68, 625
"c:\Users\khang\Desktop\FBLA\2024-25\SLC\slc-app\src\components\Interior\ApplicationCard\index.scss", "SCSS", 0, 533, 11, 77, 621
"c:\Users\khang\Desktop\FBLA\2024-25\SLC\slc-app\src\components\Interior\TeacherView\index.js", "JavaScript", 1, 0, 0, 0, 1
"c:\Users\khang\Desktop\FBLA\2024-25\SLC\slc-app\src\components\MenuInterior\index.js", "JavaScript", 5, 0, 0, 0, 5
"c:\Users\khang\Desktop\FBLA\2024-25\SLC\slc-app\src\components\MessagingPage\index.js", "JavaScript", 774, 0, 30, 78, 882
"c:\Users\khang\Desktop\FBLA\2024-25\SLC\slc-app\src\components\MessagingPage\index.scss", "SCSS", 0, 523, 11, 88, 622
"c:\Users\khang\Desktop\FBLA\2024-25\SLC\slc-app\src\components\UserPosts\index.js", "JavaScript", 98, 0, 3, 6, 107
"c:\Users\khang\Desktop\FBLA\2024-25\SLC\slc-app\src\components\UserPosts\index.scss", "SCSS", 0, 71, -23, 8, 56
"Total", "-", 1488, 1052, -94, 279, 2725