"filename", "language", "JavaScript", "SCSS", "comment", "blank", "total"
"c:\Users\khang\Desktop\FBLA\2024-25\SLC\slc-app\src\components\AccountPage\AchieveComp\index.js", "JavaScript", -18, 0, -4, -5, -27
"c:\Users\khang\Desktop\FBLA\2024-25\SLC\slc-app\src\components\AccountPage\HistoryComp\index.js", "JavaScript", -16, 0, -9, -5, -30
"c:\Users\khang\Desktop\FBLA\2024-25\SLC\slc-app\src\components\AccountPage\ProjectComp\index.js", "JavaScript", 15, 0, 3, 3, 21
"c:\Users\khang\Desktop\FBLA\2024-25\SLC\slc-app\src\components\AccountPage\SkillComp\index.js", "JavaScript", -16, 0, 0, -3, -19
"c:\Users\khang\Desktop\FBLA\2024-25\SLC\slc-app\src\components\AccountPage\index.js", "JavaScript", 28, 0, -1, 9, 36
"c:\Users\khang\Desktop\FBLA\2024-25\SLC\slc-app\src\components\AccountPage\index.scss", "SCSS", 0, 2, 0, 1, 3
"c:\Users\khang\Desktop\FBLA\2024-25\SLC\slc-app\src\components\AdminPanel\index.js", "JavaScript", 1, 0, 0, 0, 1
"c:\Users\khang\Desktop\FBLA\2024-25\SLC\slc-app\src\components\ContactDashBoard\DashboardLicensing\index.js", "JavaScript", 212, 0, 0, 7, 219
"c:\Users\khang\Desktop\FBLA\2024-25\SLC\slc-app\src\components\ContactDashBoard\DashboardLicensing\index.scss", "SCSS", 0, 200, 3, 39, 242
"c:\Users\khang\Desktop\FBLA\2024-25\SLC\slc-app\src\components\ContactDashBoard\index.js", "JavaScript", 2, 0, 2, 0, 4
"c:\Users\khang\Desktop\FBLA\2024-25\SLC\slc-app\src\components\ContactDashBoard\sideBarComp\index.js", "JavaScript", 22, 0, 2, 0, 24
"c:\Users\khang\Desktop\FBLA\2024-25\SLC\slc-app\src\components\Footer\index.scss", "SCSS", 0, -1, 0, 0, -1
"c:\Users\khang\Desktop\FBLA\2024-25\SLC\slc-app\src\components\Home\index.js", "JavaScript", 10, 0, 0, 1, 11
"c:\Users\khang\Desktop\FBLA\2024-25\SLC\slc-app\src\components\Interior\AddPostBar\index.js", "JavaScript", 23, 0, 1, 0, 24
"c:\Users\khang\Desktop\FBLA\2024-25\SLC\slc-app\src\components\Interior\AppCardTeacher\index.scss", "SCSS", 0, 3, 0, 0, 3
"c:\Users\khang\Desktop\FBLA\2024-25\SLC\slc-app\src\components\Interior\ApplicationSuccess\index.js", "JavaScript", 7, 0, 0, 3, 10
"c:\Users\khang\Desktop\FBLA\2024-25\SLC\slc-app\src\components\Interior\ApplicationSuccess\index.scss", "SCSS", 0, 1, 0, 0, 1
"c:\Users\khang\Desktop\FBLA\2024-25\SLC\slc-app\src\components\Interior\JobApplication\index.js", "JavaScript", 15, 0, -4, -4, 7
"c:\Users\khang\Desktop\FBLA\2024-25\SLC\slc-app\src\components\Interior\JobPost\index.js", "JavaScript", 135, 0, -8, 6, 133
"c:\Users\khang\Desktop\FBLA\2024-25\SLC\slc-app\src\components\Interior\JobPost\index.scss", "SCSS", 0, 144, 1, 31, 176
"c:\Users\khang\Desktop\FBLA\2024-25\SLC\slc-app\src\components\Interior\index.js", "JavaScript", 46, 0, 0, 4, 50
"c:\Users\khang\Desktop\FBLA\2024-25\SLC\slc-app\src\components\Interior\index.scss", "SCSS", 0, 7, 1, 2, 10
"c:\Users\khang\Desktop\FBLA\2024-25\SLC\slc-app\src\components\SignIn\index.js", "JavaScript", 10, 0, 0, 2, 12
"c:\Users\khang\Desktop\FBLA\2024-25\SLC\slc-app\src\components\UserPosts\index.js", "JavaScript", -30, 0, 0, -7, -37
"Total", "-", 446, 356, -13, 84, 873