"filename", "language", "JSON", "JavaScript", "SCSS", "comment", "blank", "total"
"c:\Users\khang\Desktop\FBLA\2024-25\SLC\slc-app\package-lock.json", "JSON", 7, 0, 0, 0, 0, 7
"c:\Users\khang\Desktop\FBLA\2024-25\SLC\slc-app\package.json", "JSON", 1, 0, 0, 0, 0, 1
"c:\Users\khang\Desktop\FBLA\2024-25\SLC\slc-app\src\App.js", "JavaScript", 0, -1, 0, 0, 0, -1
"c:\Users\khang\Desktop\FBLA\2024-25\SLC\slc-app\src\components\AccountPage\AchieveComp\index.scss", "SCSS", 0, 0, 1, 0, 1, 2
"c:\Users\khang\Desktop\FBLA\2024-25\SLC\slc-app\src\components\AccountPage\HistoryComp\index.scss", "SCSS", 0, 0, 1, 0, 0, 1
"c:\Users\khang\Desktop\FBLA\2024-25\SLC\slc-app\src\components\AccountPage\ProjectComp\index.scss", "SCSS", 0, 0, 1, 0, 0, 1
"c:\Users\khang\Desktop\FBLA\2024-25\SLC\slc-app\src\components\AccountPage\SkillComp\index.scss", "SCSS", 0, 0, 1, 0, 0, 1
"c:\Users\khang\Desktop\FBLA\2024-25\SLC\slc-app\src\components\AccountPage\index.js", "JavaScript", 0, 209, 0, -3, 14, 220
"c:\Users\khang\Desktop\FBLA\2024-25\SLC\slc-app\src\components\AccountPage\index.scss", "SCSS", 0, 0, -348, -20, -63, -431
"c:\Users\khang\Desktop\FBLA\2024-25\SLC\slc-app\src\components\AccountPage\index2.scss", "SCSS", 0, 0, 631, 4, 113, 748
"c:\Users\khang\Desktop\FBLA\2024-25\SLC\slc-app\src\components\AdminDashBoard\index.js", "JavaScript", 0, 31, 0, 2, -3, 30
"c:\Users\khang\Desktop\FBLA\2024-25\SLC\slc-app\src\components\AdminDashBoard\index.scss", "SCSS", 0, 0, 7, 0, 2, 9
"c:\Users\khang\Desktop\FBLA\2024-25\SLC\slc-app\src\components\Interior\AddPostBar\index.js", "JavaScript", 0, 2, 0, 0, 0, 2
"c:\Users\khang\Desktop\FBLA\2024-25\SLC\slc-app\src\components\Interior\AppCardTeacher\index.js", "JavaScript", 0, 51, 0, 2, 7, 60
"c:\Users\khang\Desktop\FBLA\2024-25\SLC\slc-app\src\components\Interior\AppCardTeacher\index.scss", "SCSS", 0, 0, 56, 3, 12, 71
"c:\Users\khang\Desktop\FBLA\2024-25\SLC\slc-app\src\components\Interior\ApplicationCard\index.js", "JavaScript", 0, 32, 0, 0, 0, 32
"c:\Users\khang\Desktop\FBLA\2024-25\SLC\slc-app\src\components\Interior\ApplicationCard\index.scss", "SCSS", 0, 0, 31, 0, 7, 38
"c:\Users\khang\Desktop\FBLA\2024-25\SLC\slc-app\src\components\Interior\JobApplication\index.js", "JavaScript", 0, -1, 0, 0, 0, -1
"c:\Users\khang\Desktop\FBLA\2024-25\SLC\slc-app\src\components\Interior\JobPost\index.js", "JavaScript", 0, -1, 0, -1, 0, -2
"c:\Users\khang\Desktop\FBLA\2024-25\SLC\slc-app\src\components\Interior\TeacherView\index.js", "JavaScript", 0, 62, 0, 2, 9, 73
"c:\Users\khang\Desktop\FBLA\2024-25\SLC\slc-app\src\components\Interior\TeacherView\index.scss", "SCSS", 0, 0, 2, 0, -2, 0
"c:\Users\khang\Desktop\FBLA\2024-25\SLC\slc-app\src\components\Interior\index.js", "JavaScript", 0, 352, 0, 13, 24, 389
"c:\Users\khang\Desktop\FBLA\2024-25\SLC\slc-app\src\components\Interior\index.scss", "SCSS", 0, 0, 512, -3, 85, 594
"c:\Users\khang\Desktop\FBLA\2024-25\SLC\slc-app\src\components\MenuInterior\index.js", "JavaScript", 0, -5, 0, 0, 0, -5
"c:\Users\khang\Desktop\FBLA\2024-25\SLC\slc-app\src\components\PreviewModule\index.js", "JavaScript", 0, 91, 0, 0, 14, 105
"c:\Users\khang\Desktop\FBLA\2024-25\SLC\slc-app\src\components\PreviewModule\index.scss", "SCSS", 0, 0, 113, 2, 18, 133
"c:\Users\khang\Desktop\FBLA\2024-25\SLC\slc-app\src\components\SignUp\index.js", "JavaScript", 0, -6, 0, 0, 0, -6
"Total", "-", 8, 816, 1008, 1, 238, 2071